B	B	B	B	B	B	B	B	B	B	B	B	B
B	FTL	FH	FH	FH	FH	FH	FH	FH	FH	FH	FTR	B
B	FV	F	F	F	F	F	F	F	F	F	FV	B
B	FV	F	F	F	F	S	F	F	F	F	FV	B
B	FV	F	F	F	F	F	F	F	F	F	FV	B
B	FV	F	F	F	F	W	F	F	F	F	FV	B
B	FV	F	F	F	F	F	F	F	F	F	FV	B
B	FV	F	F	F	F	F	F	F	F	F	FV	B
B	FV	F	W	F	F	G	F	F	W	F	FV	B
B	FV	F	F	F	F	F	F	F	F	F	FV	B
B	FV	F	F	F	F	F	F	F	F	F	FV	B
B	FV	F	F	F	F	W	F	F	F	F	FV	B
B	FV	F	F	F	F	F	F	F	F	F	FV	B
B	FV	F	F	F	F	S	F	F	F	F	FV	B
B	FV	F	F	F	F	F	F	F	F	F	FV	B
B	FBL	FH	FH	FH	FH	FH	FH	FH	FH	FH	FBR	B
B	B	B	B	B	B	B	B	B	B	B	B	B
